surround: vây quanh
fully wheelchair accessible: xe lăn hoàn toàn có thể use
unobtrsive: không phô trương
footpath: lỗi đi bộ
complimentary and eco-friendly toiletries: đồ vệ sinh cá nhân miễn phí và thân thiện vs môi trường
restroom: nhà vệ sinh
humour: hài hước, làm hài lòng
curtain: rèm cửa
towels: khăn tắm
blankets: chăn
pillow cases: vỏ gối
sheet: ga trải giường
reclaim: đòi lại, khai hoang, tái sử dụng
planting: trồng cây
in fact: trên thực tế
proud: tự hào
forefront: đi đầu
accessibility: khả năng tiếp cận
disability: khuyết tật
balcony: ban công
fence: hàng rào
sustainable: bền vững
property: tính chất, đặc tính
recycle: tái chế
repurpose: tái sử dụng
purpose: mục đích
furniture: đồ nội thất
fittings: phụ kiện
brick: viên gạch
landfill: bãi rác
cement: xi măng
fabrict: đồ dùng = vải
sparingly: tiết kiệm
encourage:khuyến khích
faucet: vòi nước
brush your teeths: đánh răng
shower: vòi hoa sen
laundry service: giặt ủi
fresh: tươi mới
inconvenience: bất tiện
waste: lãng phí, chất thải
napkin: khăn ăn
to their fullest: hết mình
located in: nằm ở









